Rain check : ติดไว้ก่อนนะ

We’ll figure it out later : ค่อยว่ากันนะ

You’ll see : เดี๋ยวรู้เลย

Accept it / Let it go : ทำใจเถอะ

Come on : เอาหน่า

Sigh / Geez : เฮ้อออ

That’s way too much : โคตรเยอะเลย

Fingers crossed for you : เอาใจช่วยนะ

You got it! : จัดไปดิ

Just so-so : เฉย ๆ นะ

Totally got hit by it : โดนเต็ม ๆ เลย

Just going with the flow : ไปเรื่อย

You can do it! : สู้ ๆ นะ

Or else they’ll say… : เดี๋ยวหาว่า

Secretly check / Peek : แอบส่อง

The suspense is killing me : ลุ้นแทบตาย

That’s amazing! / That slaps! : ปังมาก

It’s trending : ติดเทรนด์

Smooth it over : เนียน ๆ ไป

I knew it! : ว่าแล้วเชียว

Prepare yourself : ทำใจไว้ก่อน

Too much to handle : ไม่ไหวจะเคลียร์

I’m drained : เหนื่อยใจ

I’m secretly glad : แอบดีใจ

That stings : เจ็บจี๊ด

Spot on : ตรงเป๊ะ

That’s something else : ไม่ธรรมดา

Just kidding : พูดเล่น

Be serious : เอาดี ๆ

Better safe than sorry : ทำบุญไว้ก่อน